   R 		800       90000 

NO ./textures/brick.xpm
SO ./textures/blue.xpm
WE ./textures/wood.xpm
        EA ./textures/grey.xpm

S ./textures/barrel.xpm
F 142141240 ,0,100
C 0,0,10

111111111111111111111111111111111
111111111W00000000110000000000001
111111111011000001110000002000001
111111111001000000000000000000001
111111111011000001110000000000001
100000000011000001110111111111111
111101111111110111000000100011111
111101111111110111010100100011111
100000001101010111000000100011111
100020000000000011000000100011111
100000000000000011010100100011111
110000011101010111110111100011111
111101111111010111011110100011111
111111111111111111111111111111111
