R 	100 100

NO	./textures/brick.xpm

SO	./textures/blue.xmp

WE	./textures/wood.xpm

EA	./textures/grey.xpm

S	./textures/barrel.xpm

F	12,14,255

C	205,249,255

11111111111
10001000011
10001000011
11111010011
10010010011
10010010011
10010110011
10000000011
10000000011
11111111111
11111111111
