            R        900 900

        NO        ./textures/brick.xpm

        SO                 ./textures/blue.png

          WE         ./textures/wood.xpm

        EA       ./textures/grey.xpm

        S          ./textures/barrel.xpm

            F       12      , 14,           255
        C       22 , 23              ,10

0000001111
1111111001
100W000011
1000000001
1111111111
